tick,iso8601,tests performed,tests performed (resident),positive tests,positive tests (resident),cumulative positive tests
144,02/24/2020T00:00:00 ,0,0,0,0,0
288,02/25/2020T00:00:00 ,0,0,0,0,0
432,02/26/2020T00:00:00 ,0,0,0,0,0
576,02/27/2020T00:00:00 ,1,1,1,1,1
720,02/28/2020T00:00:00 ,1,1,1,1,2
864,02/29/2020T00:00:00 ,1,1,1,1,3
1008,03/01/2020T00:00:00 ,1,1,0,0,3
1152,03/02/2020T00:00:00 ,1,1,1,1,4
1296,03/03/2020T00:00:00 ,1,1,1,1,5
1440,03/04/2020T00:00:00 ,1,1,0,0,5
1584,03/05/2020T00:00:00 ,2,1,2,1,7
1728,03/06/2020T00:00:00 ,2,1,2,1,9
1872,03/07/2020T00:00:00 ,2,2,1,1,10
2016,03/08/2020T00:00:00 ,3,2,2,2,12
2160,03/09/2020T00:00:00 ,4,4,2,2,14
2304,03/10/2020T00:00:00 ,11,3,9,3,23
2448,03/11/2020T00:00:00 ,18,13,9,7,32
2592,03/12/2020T00:00:00 ,22,11,9,7,41
2736,03/13/2020T00:00:00 ,24,14,14,8,55
2880,03/14/2020T00:00:00 ,37,19,18,10,73
3024,03/15/2020T00:00:00 ,61,27,28,8,101
3168,03/16/2020T00:00:00 ,70,42,29,18,130
3312,03/17/2020T00:00:00 ,66,36,33,16,163
3456,03/18/2020T00:00:00 ,64,36,25,15,188
3600,03/19/2020T00:00:00 ,120,69,57,26,245
3744,03/20/2020T00:00:00 ,98,54,40,20,285
3888,03/21/2020T00:00:00 ,105,67,46,29,331
4032,03/22/2020T00:00:00 ,85,47,32,18,363
4176,03/23/2020T00:00:00 ,82,51,40,25,403
4320,03/24/2020T00:00:00 ,67,47,39,27,442
4464,03/25/2020T00:00:00 ,59,41,36,22,478
4608,03/26/2020T00:00:00 ,56,30,25,13,503
4752,03/27/2020T00:00:00 ,45,29,21,12,524
4896,03/28/2020T00:00:00 ,38,26,19,14,543
5040,03/29/2020T00:00:00 ,30,20,13,10,556
5184,03/30/2020T00:00:00 ,12,12,4,4,560
5328,03/31/2020T00:00:00 ,25,15,12,5,572
5472,04/01/2020T00:00:00 ,21,17,6,5,578
5616,04/02/2020T00:00:00 ,32,21,14,12,592
5760,04/03/2020T00:00:00 ,34,23,14,10,606
5904,04/04/2020T00:00:00 ,36,24,19,14,625
6048,04/05/2020T00:00:00 ,49,26,26,11,651
6192,04/06/2020T00:00:00 ,27,23,13,11,664
6336,04/07/2020T00:00:00 ,36,23,17,10,681
6480,04/08/2020T00:00:00 ,47,27,31,18,712
6624,04/09/2020T00:00:00 ,44,28,26,18,738
6768,04/10/2020T00:00:00 ,45,33,18,13,756
6912,04/11/2020T00:00:00 ,28,23,14,11,770
7056,04/12/2020T00:00:00 ,42,25,18,9,788
7200,04/13/2020T00:00:00 ,28,16,15,7,803
7344,04/14/2020T00:00:00 ,29,20,14,10,817
7488,04/15/2020T00:00:00 ,17,12,9,5,826
7632,04/16/2020T00:00:00 ,38,27,17,11,843
7776,04/17/2020T00:00:00 ,20,17,8,7,851
7920,04/18/2020T00:00:00 ,15,12,7,6,858
8064,04/19/2020T00:00:00 ,25,20,11,11,869
8208,04/20/2020T00:00:00 ,7,5,2,1,871
8352,04/21/2020T00:00:00 ,14,10,5,4,876
8496,04/22/2020T00:00:00 ,17,13,9,7,885
8640,04/23/2020T00:00:00 ,50,23,32,15,917
8784,04/24/2020T00:00:00 ,10,9,6,6,923
8928,04/25/2020T00:00:00 ,258,173,10,6,933
9072,04/26/2020T00:00:00 ,200,140,15,9,948
9216,04/27/2020T00:00:00 ,77,40,32,17,980
9360,04/28/2020T00:00:00 ,91,55,3,2,983
9504,04/29/2020T00:00:00 ,359,242,41,33,1024
9648,04/30/2020T00:00:00 ,294,196,16,9,1040
9792,05/01/2020T00:00:00 ,190,146,20,15,1060
9936,05/02/2020T00:00:00 ,377,277,3,3,1063
10080,05/03/2020T00:00:00 ,362,308,29,27,1092
10224,05/04/2020T00:00:00 ,46,38,15,9,1107
10368,05/05/2020T00:00:00 ,267,176,22,20,1129
10512,05/06/2020T00:00:00 ,337,269,9,5,1138
10656,05/07/2020T00:00:00 ,337,282,27,23,1165
10800,05/08/2020T00:00:00 ,43,36,16,10,1181
10944,05/09/2020T00:00:00 ,334,243,14,14,1195
11088,05/10/2020T00:00:00 ,340,239,5,4,1200
11232,05/11/2020T00:00:00 ,330,271,22,17,1222
11376,05/12/2020T00:00:00 ,193,121,16,7,1238
11520,05/13/2020T00:00:00 ,259,166,8,8,1246
11664,05/14/2020T00:00:00 ,338,228,0,0,1246
11808,05/15/2020T00:00:00 ,136,96,11,9,1257
11952,05/16/2020T00:00:00 ,11,8,6,4,1263
12096,05/17/2020T00:00:00 ,317,223,6,5,1269
12240,05/18/2020T00:00:00 ,324,258,5,2,1274
12384,05/19/2020T00:00:00 ,134,94,6,5,1280
12528,05/20/2020T00:00:00 ,4,3,2,2,1282
12672,05/21/2020T00:00:00 ,299,264,5,5,1287
12816,05/22/2020T00:00:00 ,296,227,2,2,1289
12960,05/23/2020T00:00:00 ,144,100,4,2,1293
13104,05/24/2020T00:00:00 ,14,12,0,0,1293
13248,05/25/2020T00:00:00 ,141,121,14,13,1307
13392,05/26/2020T00:00:00 ,367,296,2,2,1309
13536,05/27/2020T00:00:00 ,417,353,1,1,1310
13680,05/28/2020T00:00:00 ,24,21,0,0,1310
13824,05/29/2020T00:00:00 ,284,168,3,3,1313
13968,05/30/2020T00:00:00 ,328,256,0,0,1313
14112,05/31/2020T00:00:00 ,500,395,31,29,1344
14256,06/01/2020T00:00:00 ,497,363,0,0,1344
14400,06/02/2020T00:00:00 ,530,411,3,3,1347
14544,06/03/2020T00:00:00 ,526,402,0,0,1347
14688,06/04/2020T00:00:00 ,542,412,30,28,1377
14832,06/05/2020T00:00:00 ,634,495,0,0,1377
14976,06/06/2020T00:00:00 ,676,535,8,8,1385
15120,06/07/2020T00:00:00 ,770,562,0,0,1385
15264,06/08/2020T00:00:00 ,858,686,29,26,1414
15408,06/09/2020T00:00:00 ,983,743,0,0,1414
15552,06/10/2020T00:00:00 ,1040,800,11,11,1425
15696,06/11/2020T00:00:00 ,837,629,0,0,1425
15840,06/12/2020T00:00:00 ,982,746,17,15,1442
15984,06/13/2020T00:00:00 ,1240,954,0,0,1442
16128,06/14/2020T00:00:00 ,1318,1010,12,12,1454
16272,06/15/2020T00:00:00 ,1411,1072,0,0,1454
16416,06/16/2020T00:00:00 ,1445,1116,13,11,1467
16560,06/17/2020T00:00:00 ,1533,1162,0,0,1467
16704,06/18/2020T00:00:00 ,1527,1187,11,10,1478
16848,06/19/2020T00:00:00 ,1570,1206,0,0,1478
16992,06/20/2020T00:00:00 ,1357,1061,7,6,1485
17136,06/21/2020T00:00:00 ,1315,1019,0,0,1485
17280,06/22/2020T00:00:00 ,1284,998,5,5,1490
17424,06/23/2020T00:00:00 ,1237,958,0,0,1490
17568,06/24/2020T00:00:00 ,1229,950,4,4,1494
17712,06/25/2020T00:00:00 ,1244,954,0,0,1494
17856,06/26/2020T00:00:00 ,1319,1013,1,1,1495
18000,06/27/2020T00:00:00 ,1626,1252,0,0,1495
18144,06/28/2020T00:00:00 ,1801,1404,0,0,1495
18288,06/29/2020T00:00:00 ,2006,1548,0,0,1495
18432,06/30/2020T00:00:00 ,2182,1676,0,0,1495
