tick,iso8601,tests performed,tests performed (resident),positive tests,positive tests (resident),cumulative positive tests
144,02/24/2020T00:00:00 ,0,0,0,0,0
288,02/25/2020T00:00:00 ,0,0,0,0,0
432,02/26/2020T00:00:00 ,0,0,0,0,0
576,02/27/2020T00:00:00 ,1,1,0,0,0
720,02/28/2020T00:00:00 ,1,1,1,1,1
864,02/29/2020T00:00:00 ,1,1,1,1,2
1008,03/01/2020T00:00:00 ,1,1,1,1,3
1152,03/02/2020T00:00:00 ,1,1,1,1,4
1296,03/03/2020T00:00:00 ,1,1,0,0,4
1440,03/04/2020T00:00:00 ,1,1,0,0,4
1584,03/05/2020T00:00:00 ,2,0,0,0,4
1728,03/06/2020T00:00:00 ,2,1,2,1,6
1872,03/07/2020T00:00:00 ,1,1,1,1,7
2016,03/08/2020T00:00:00 ,1,1,1,1,8
2160,03/09/2020T00:00:00 ,3,0,2,0,10
2304,03/10/2020T00:00:00 ,1,1,1,1,11
2448,03/11/2020T00:00:00 ,7,2,2,1,13
2592,03/12/2020T00:00:00 ,1,0,1,0,14
2736,03/13/2020T00:00:00 ,5,0,3,0,17
2880,03/14/2020T00:00:00 ,5,2,4,2,21
3024,03/15/2020T00:00:00 ,10,4,4,2,25
3168,03/16/2020T00:00:00 ,4,3,2,2,27
3312,03/17/2020T00:00:00 ,12,3,4,0,31
3456,03/18/2020T00:00:00 ,11,5,8,5,39
3600,03/19/2020T00:00:00 ,15,5,7,3,46
3744,03/20/2020T00:00:00 ,22,13,8,4,54
3888,03/21/2020T00:00:00 ,24,11,9,5,63
4032,03/22/2020T00:00:00 ,17,6,9,3,72
4176,03/23/2020T00:00:00 ,24,7,13,3,85
4320,03/24/2020T00:00:00 ,8,2,3,0,88
4464,03/25/2020T00:00:00 ,23,15,13,9,101
4608,03/26/2020T00:00:00 ,16,9,8,5,109
4752,03/27/2020T00:00:00 ,27,16,13,7,122
4896,03/28/2020T00:00:00 ,10,7,4,4,126
5040,03/29/2020T00:00:00 ,4,4,1,1,127
5184,03/30/2020T00:00:00 ,6,3,3,2,130
5328,03/31/2020T00:00:00 ,3,2,3,2,133
5472,04/01/2020T00:00:00 ,3,2,1,0,134
5616,04/02/2020T00:00:00 ,1,1,1,1,135
5760,04/03/2020T00:00:00 ,2,1,2,1,137
5904,04/04/2020T00:00:00 ,4,4,2,2,139
6048,04/05/2020T00:00:00 ,2,2,0,0,139
6192,04/06/2020T00:00:00 ,0,0,0,0,139
6336,04/07/2020T00:00:00 ,4,4,1,1,140
6480,04/08/2020T00:00:00 ,2,2,1,1,141
6624,04/09/2020T00:00:00 ,0,0,0,0,141
6768,04/10/2020T00:00:00 ,2,1,2,1,143
6912,04/11/2020T00:00:00 ,3,2,2,1,145
7056,04/12/2020T00:00:00 ,4,2,1,0,146
7200,04/13/2020T00:00:00 ,1,1,0,0,146
7344,04/14/2020T00:00:00 ,6,5,2,2,148
7488,04/15/2020T00:00:00 ,2,2,1,1,149
7632,04/16/2020T00:00:00 ,1,1,0,0,149
7776,04/17/2020T00:00:00 ,4,2,2,0,151
7920,04/18/2020T00:00:00 ,6,2,3,2,154
8064,04/19/2020T00:00:00 ,2,1,2,1,156
8208,04/20/2020T00:00:00 ,4,2,0,0,156
8352,04/21/2020T00:00:00 ,2,2,1,1,157
8496,04/22/2020T00:00:00 ,2,1,2,1,159
8640,04/23/2020T00:00:00 ,3,2,2,1,161
8784,04/24/2020T00:00:00 ,0,0,0,0,161
8928,04/25/2020T00:00:00 ,258,231,4,4,165
9072,04/26/2020T00:00:00 ,3,2,1,1,166
9216,04/27/2020T00:00:00 ,6,5,1,1,167
9360,04/28/2020T00:00:00 ,230,134,0,0,167
9504,04/29/2020T00:00:00 ,359,359,6,6,173
9648,04/30/2020T00:00:00 ,0,0,0,0,173
9792,05/01/2020T00:00:00 ,119,89,2,2,175
9936,05/02/2020T00:00:00 ,0,0,0,0,175
10080,05/03/2020T00:00:00 ,362,362,4,4,179
10224,05/04/2020T00:00:00 ,0,0,0,0,179
10368,05/05/2020T00:00:00 ,18,15,3,2,182
10512,05/06/2020T00:00:00 ,0,0,0,0,182
10656,05/07/2020T00:00:00 ,337,337,4,4,186
10800,05/08/2020T00:00:00 ,0,0,0,0,186
10944,05/09/2020T00:00:00 ,14,11,2,1,188
11088,05/10/2020T00:00:00 ,0,0,0,0,188
11232,05/11/2020T00:00:00 ,330,252,1,1,189
11376,05/12/2020T00:00:00 ,0,0,0,0,189
11520,05/13/2020T00:00:00 ,10,8,1,1,190
11664,05/14/2020T00:00:00 ,0,0,0,0,190
11808,05/15/2020T00:00:00 ,336,336,1,1,191
11952,05/16/2020T00:00:00 ,0,0,0,0,191
12096,05/17/2020T00:00:00 ,9,6,0,0,191
12240,05/18/2020T00:00:00 ,0,0,0,0,191
12384,05/19/2020T00:00:00 ,300,300,1,1,192
12528,05/20/2020T00:00:00 ,0,0,0,0,192
12672,05/21/2020T00:00:00 ,9,6,0,0,192
12816,05/22/2020T00:00:00 ,0,0,0,0,192
12960,05/23/2020T00:00:00 ,10,6,0,0,192
13104,05/24/2020T00:00:00 ,12,10,0,0,192
13248,05/25/2020T00:00:00 ,317,312,0,0,192
13392,05/26/2020T00:00:00 ,19,13,0,0,192
13536,05/27/2020T00:00:00 ,8,6,0,0,192
13680,05/28/2020T00:00:00 ,18,14,0,0,192
13824,05/29/2020T00:00:00 ,38,30,0,0,192
13968,05/30/2020T00:00:00 ,344,267,0,0,192
14112,05/31/2020T00:00:00 ,297,238,0,0,192
14256,06/01/2020T00:00:00 ,497,390,0,0,192
14400,06/02/2020T00:00:00 ,530,404,0,0,192
14544,06/03/2020T00:00:00 ,492,368,0,0,192
14688,06/04/2020T00:00:00 ,542,412,0,0,192
14832,06/05/2020T00:00:00 ,634,497,0,0,192
14976,06/06/2020T00:00:00 ,676,516,0,0,192
15120,06/07/2020T00:00:00 ,770,587,0,0,192
15264,06/08/2020T00:00:00 ,858,649,0,0,192
15408,06/09/2020T00:00:00 ,983,767,0,0,192
15552,06/10/2020T00:00:00 ,1040,819,0,0,192
15696,06/11/2020T00:00:00 ,838,669,0,0,192
15840,06/12/2020T00:00:00 ,799,626,0,0,192
15984,06/13/2020T00:00:00 ,1240,936,0,0,192
16128,06/14/2020T00:00:00 ,1318,1014,0,0,192
16272,06/15/2020T00:00:00 ,1411,1087,0,0,192
16416,06/16/2020T00:00:00 ,1445,1099,0,0,192
16560,06/17/2020T00:00:00 ,1533,1180,0,0,192
16704,06/18/2020T00:00:00 ,1527,1182,0,0,192
16848,06/19/2020T00:00:00 ,1570,1236,0,0,192
16992,06/20/2020T00:00:00 ,1357,1053,0,0,192
17136,06/21/2020T00:00:00 ,1315,1021,0,0,192
17280,06/22/2020T00:00:00 ,1284,1004,0,0,192
17424,06/23/2020T00:00:00 ,1237,976,0,0,192
17568,06/24/2020T00:00:00 ,1229,948,0,0,192
17712,06/25/2020T00:00:00 ,1244,971,0,0,192
17856,06/26/2020T00:00:00 ,1319,998,0,0,192
18000,06/27/2020T00:00:00 ,1626,1263,0,0,192
18144,06/28/2020T00:00:00 ,1801,1373,0,0,192
18288,06/29/2020T00:00:00 ,2006,1554,0,0,192
18432,06/30/2020T00:00:00 ,2182,1671,0,0,192
