tick,iso8601,tests performed,tests performed (resident),positive tests,positive tests (resident),cumulative positive tests
144,02/24/2020T00:00:00 ,0,0,0,0,0
288,02/25/2020T00:00:00 ,0,0,0,0,0
432,02/26/2020T00:00:00 ,0,0,0,0,0
576,02/27/2020T00:00:00 ,1,1,1,1,1
720,02/28/2020T00:00:00 ,1,1,1,1,2
864,02/29/2020T00:00:00 ,1,1,1,1,3
1008,03/01/2020T00:00:00 ,1,1,1,1,4
1152,03/02/2020T00:00:00 ,1,1,0,0,4
1296,03/03/2020T00:00:00 ,1,1,1,1,5
1440,03/04/2020T00:00:00 ,1,1,0,0,5
1584,03/05/2020T00:00:00 ,2,1,2,1,7
1728,03/06/2020T00:00:00 ,2,2,1,1,8
1872,03/07/2020T00:00:00 ,2,1,1,1,9
2016,03/08/2020T00:00:00 ,3,1,0,0,9
2160,03/09/2020T00:00:00 ,6,3,3,2,12
2304,03/10/2020T00:00:00 ,11,6,6,3,18
2448,03/11/2020T00:00:00 ,18,9,9,3,27
2592,03/12/2020T00:00:00 ,23,13,14,8,41
2736,03/13/2020T00:00:00 ,23,17,12,10,53
2880,03/14/2020T00:00:00 ,40,17,16,6,69
3024,03/15/2020T00:00:00 ,62,36,24,16,93
3168,03/16/2020T00:00:00 ,64,28,36,14,129
3312,03/17/2020T00:00:00 ,61,45,32,25,161
3456,03/18/2020T00:00:00 ,63,41,31,21,192
3600,03/19/2020T00:00:00 ,82,59,43,33,235
3744,03/20/2020T00:00:00 ,91,56,53,33,288
3888,03/21/2020T00:00:00 ,93,63,52,35,340
4032,03/22/2020T00:00:00 ,80,52,35,26,375
4176,03/23/2020T00:00:00 ,65,42,32,20,407
4320,03/24/2020T00:00:00 ,67,41,30,18,437
4464,03/25/2020T00:00:00 ,57,36,34,22,471
4608,03/26/2020T00:00:00 ,66,43,38,21,509
4752,03/27/2020T00:00:00 ,51,27,30,19,539
4896,03/28/2020T00:00:00 ,65,39,27,14,566
5040,03/29/2020T00:00:00 ,36,25,18,13,584
5184,03/30/2020T00:00:00 ,36,25,16,11,600
5328,03/31/2020T00:00:00 ,22,13,18,11,618
5472,04/01/2020T00:00:00 ,26,17,20,12,638
5616,04/02/2020T00:00:00 ,54,38,27,17,665
5760,04/03/2020T00:00:00 ,30,20,20,14,685
5904,04/04/2020T00:00:00 ,38,21,28,17,713
6048,04/05/2020T00:00:00 ,22,14,11,7,724
6192,04/06/2020T00:00:00 ,22,14,8,4,732
6336,04/07/2020T00:00:00 ,32,22,20,13,752
6480,04/08/2020T00:00:00 ,23,19,9,9,761
6624,04/09/2020T00:00:00 ,25,23,10,10,771
6768,04/10/2020T00:00:00 ,25,20,12,10,783
6912,04/11/2020T00:00:00 ,23,19,19,16,802
7056,04/12/2020T00:00:00 ,21,14,15,12,817
7200,04/13/2020T00:00:00 ,15,11,5,4,822
7344,04/14/2020T00:00:00 ,19,17,8,6,830
7488,04/15/2020T00:00:00 ,21,16,12,10,842
7632,04/16/2020T00:00:00 ,15,12,10,8,852
7776,04/17/2020T00:00:00 ,21,15,12,9,864
7920,04/18/2020T00:00:00 ,25,19,16,11,880
8064,04/19/2020T00:00:00 ,19,13,8,7,888
8208,04/20/2020T00:00:00 ,16,14,9,7,897
8352,04/21/2020T00:00:00 ,15,14,11,11,908
8496,04/22/2020T00:00:00 ,18,16,8,7,916
8640,04/23/2020T00:00:00 ,45,37,31,26,947
8784,04/24/2020T00:00:00 ,26,21,19,15,966
8928,04/25/2020T00:00:00 ,258,255,6,3,972
9072,04/26/2020T00:00:00 ,254,193,23,20,995
9216,04/27/2020T00:00:00 ,227,174,31,28,1026
9360,04/28/2020T00:00:00 ,114,93,29,26,1055
9504,04/29/2020T00:00:00 ,359,282,14,13,1069
9648,04/30/2020T00:00:00 ,362,288,17,15,1086
9792,05/01/2020T00:00:00 ,194,147,34,32,1120
9936,05/02/2020T00:00:00 ,377,327,0,0,1120
10080,05/03/2020T00:00:00 ,362,269,15,13,1135
10224,05/04/2020T00:00:00 ,246,187,13,10,1148
10368,05/05/2020T00:00:00 ,334,250,6,4,1154
10512,05/06/2020T00:00:00 ,44,29,1,1,1155
10656,05/07/2020T00:00:00 ,329,247,11,11,1166
10800,05/08/2020T00:00:00 ,22,20,18,17,1184
10944,05/09/2020T00:00:00 ,334,280,2,2,1186
11088,05/10/2020T00:00:00 ,340,245,3,3,1189
11232,05/11/2020T00:00:00 ,19,16,3,3,1192
11376,05/12/2020T00:00:00 ,83,53,9,9,1201
11520,05/13/2020T00:00:00 ,324,279,1,0,1202
11664,05/14/2020T00:00:00 ,338,269,6,6,1208
11808,05/15/2020T00:00:00 ,284,187,5,4,1213
11952,05/16/2020T00:00:00 ,14,14,5,5,1218
12096,05/17/2020T00:00:00 ,317,238,1,0,1219
12240,05/18/2020T00:00:00 ,324,252,2,2,1221
12384,05/19/2020T00:00:00 ,231,145,2,1,1223
12528,05/20/2020T00:00:00 ,36,36,2,2,1225
12672,05/21/2020T00:00:00 ,275,181,2,2,1227
12816,05/22/2020T00:00:00 ,140,99,0,0,1227
12960,05/23/2020T00:00:00 ,304,227,0,0,1227
13104,05/24/2020T00:00:00 ,17,16,0,0,1227
13248,05/25/2020T00:00:00 ,260,167,0,0,1227
13392,05/26/2020T00:00:00 ,170,124,0,0,1227
13536,05/27/2020T00:00:00 ,389,262,2,2,1229
13680,05/28/2020T00:00:00 ,24,18,0,0,1229
13824,05/29/2020T00:00:00 ,22,18,0,0,1229
13968,05/30/2020T00:00:00 ,312,246,0,0,1229
14112,05/31/2020T00:00:00 ,347,268,0,0,1229
14256,06/01/2020T00:00:00 ,497,374,0,0,1229
14400,06/02/2020T00:00:00 ,530,405,0,0,1229
14544,06/03/2020T00:00:00 ,526,423,0,0,1229
14688,06/04/2020T00:00:00 ,513,415,0,0,1229
14832,06/05/2020T00:00:00 ,634,462,0,0,1229
14976,06/06/2020T00:00:00 ,676,525,0,0,1229
15120,06/07/2020T00:00:00 ,770,596,0,0,1229
15264,06/08/2020T00:00:00 ,858,663,0,0,1229
15408,06/09/2020T00:00:00 ,983,746,0,0,1229
15552,06/10/2020T00:00:00 ,1040,830,0,0,1229
15696,06/11/2020T00:00:00 ,801,624,0,0,1229
15840,06/12/2020T00:00:00 ,802,615,0,0,1229
15984,06/13/2020T00:00:00 ,1240,951,0,0,1229
16128,06/14/2020T00:00:00 ,1318,1035,0,0,1229
16272,06/15/2020T00:00:00 ,1411,1085,0,0,1229
16416,06/16/2020T00:00:00 ,1445,1126,0,0,1229
16560,06/17/2020T00:00:00 ,1533,1193,0,0,1229
16704,06/18/2020T00:00:00 ,1527,1209,0,0,1229
16848,06/19/2020T00:00:00 ,1570,1210,0,0,1229
16992,06/20/2020T00:00:00 ,1357,1057,0,0,1229
17136,06/21/2020T00:00:00 ,1315,989,0,0,1229
17280,06/22/2020T00:00:00 ,1284,992,0,0,1229
17424,06/23/2020T00:00:00 ,1237,942,0,0,1229
17568,06/24/2020T00:00:00 ,1229,960,0,0,1229
17712,06/25/2020T00:00:00 ,1244,939,0,0,1229
17856,06/26/2020T00:00:00 ,1319,1002,0,0,1229
18000,06/27/2020T00:00:00 ,1626,1233,0,0,1229
18144,06/28/2020T00:00:00 ,1801,1375,0,0,1229
18288,06/29/2020T00:00:00 ,2006,1538,0,0,1229
18432,06/30/2020T00:00:00 ,2182,1696,0,0,1229
