tick,iso8601,tests performed,tests performed (resident),positive tests,positive tests (resident),cumulative positive tests
144,02/24/2020T00:00:00 ,0,0,0,0,0
288,02/25/2020T00:00:00 ,0,0,0,0,0
432,02/26/2020T00:00:00 ,0,0,0,0,0
576,02/27/2020T00:00:00 ,1,1,0,0,0
720,02/28/2020T00:00:00 ,1,1,1,1,1
864,02/29/2020T00:00:00 ,1,1,1,1,2
1008,03/01/2020T00:00:00 ,1,1,1,1,3
1152,03/02/2020T00:00:00 ,1,1,1,1,4
1296,03/03/2020T00:00:00 ,1,0,1,0,5
1440,03/04/2020T00:00:00 ,1,1,1,1,6
1584,03/05/2020T00:00:00 ,0,0,0,0,6
1728,03/06/2020T00:00:00 ,2,2,0,0,6
1872,03/07/2020T00:00:00 ,2,1,0,0,6
2016,03/08/2020T00:00:00 ,3,2,2,1,8
2160,03/09/2020T00:00:00 ,1,1,0,0,8
2304,03/10/2020T00:00:00 ,5,3,1,0,9
2448,03/11/2020T00:00:00 ,6,3,4,3,13
2592,03/12/2020T00:00:00 ,11,5,4,2,17
2736,03/13/2020T00:00:00 ,18,10,13,7,30
2880,03/14/2020T00:00:00 ,12,4,6,2,36
3024,03/15/2020T00:00:00 ,20,14,10,5,46
3168,03/16/2020T00:00:00 ,15,6,8,4,54
3312,03/17/2020T00:00:00 ,23,12,11,7,65
3456,03/18/2020T00:00:00 ,23,14,10,8,75
3600,03/19/2020T00:00:00 ,26,16,13,8,88
3744,03/20/2020T00:00:00 ,33,21,18,13,106
3888,03/21/2020T00:00:00 ,35,19,14,5,120
4032,03/22/2020T00:00:00 ,31,17,10,7,130
4176,03/23/2020T00:00:00 ,30,14,9,4,139
4320,03/24/2020T00:00:00 ,25,13,14,9,153
4464,03/25/2020T00:00:00 ,25,15,16,8,169
4608,03/26/2020T00:00:00 ,22,13,12,5,181
4752,03/27/2020T00:00:00 ,25,21,12,10,193
4896,03/28/2020T00:00:00 ,12,8,8,5,201
5040,03/29/2020T00:00:00 ,13,8,6,2,207
5184,03/30/2020T00:00:00 ,9,8,4,3,211
5328,03/31/2020T00:00:00 ,6,5,5,4,216
5472,04/01/2020T00:00:00 ,11,8,5,4,221
5616,04/02/2020T00:00:00 ,11,5,7,3,228
5760,04/03/2020T00:00:00 ,13,12,9,9,237
5904,04/04/2020T00:00:00 ,12,9,7,5,244
6048,04/05/2020T00:00:00 ,10,5,5,1,249
6192,04/06/2020T00:00:00 ,12,8,5,4,254
6336,04/07/2020T00:00:00 ,7,5,3,1,257
6480,04/08/2020T00:00:00 ,6,4,6,4,263
6624,04/09/2020T00:00:00 ,10,6,7,5,270
6768,04/10/2020T00:00:00 ,4,2,1,0,271
6912,04/11/2020T00:00:00 ,11,6,6,4,277
7056,04/12/2020T00:00:00 ,10,5,6,3,283
7200,04/13/2020T00:00:00 ,9,7,4,3,287
7344,04/14/2020T00:00:00 ,7,6,3,2,290
7488,04/15/2020T00:00:00 ,8,4,5,1,295
7632,04/16/2020T00:00:00 ,8,5,3,3,298
7776,04/17/2020T00:00:00 ,8,5,5,3,303
7920,04/18/2020T00:00:00 ,6,4,4,3,307
8064,04/19/2020T00:00:00 ,5,2,4,2,311
8208,04/20/2020T00:00:00 ,5,4,1,1,312
8352,04/21/2020T00:00:00 ,4,2,3,1,315
8496,04/22/2020T00:00:00 ,3,3,2,2,317
8640,04/23/2020T00:00:00 ,19,13,13,8,330
8784,04/24/2020T00:00:00 ,3,3,3,3,333
8928,04/25/2020T00:00:00 ,258,257,13,13,346
9072,04/26/2020T00:00:00 ,9,7,8,6,354
9216,04/27/2020T00:00:00 ,316,287,12,7,366
9360,04/28/2020T00:00:00 ,15,12,9,6,375
9504,04/29/2020T00:00:00 ,359,304,11,7,386
9648,04/30/2020T00:00:00 ,7,7,4,4,390
9792,05/01/2020T00:00:00 ,39,32,13,7,403
9936,05/02/2020T00:00:00 ,170,139,32,31,435
10080,05/03/2020T00:00:00 ,362,306,18,15,453
10224,05/04/2020T00:00:00 ,248,164,14,13,467
10368,05/05/2020T00:00:00 ,20,14,4,2,471
10512,05/06/2020T00:00:00 ,215,180,30,29,501
10656,05/07/2020T00:00:00 ,337,300,11,9,512
10800,05/08/2020T00:00:00 ,250,167,12,12,524
10944,05/09/2020T00:00:00 ,28,23,4,1,528
11088,05/10/2020T00:00:00 ,213,172,34,28,562
11232,05/11/2020T00:00:00 ,330,300,7,6,569
11376,05/12/2020T00:00:00 ,324,228,0,0,569
11520,05/13/2020T00:00:00 ,17,14,2,1,571
11664,05/14/2020T00:00:00 ,168,137,28,23,599
11808,05/15/2020T00:00:00 ,336,301,2,2,601
11952,05/16/2020T00:00:00 ,273,188,1,1,602
12096,05/17/2020T00:00:00 ,18,15,4,3,606
12240,05/18/2020T00:00:00 ,11,10,8,8,614
12384,05/19/2020T00:00:00 ,300,300,3,3,617
12528,05/20/2020T00:00:00 ,233,193,4,4,621
12672,05/21/2020T00:00:00 ,13,10,8,8,629
12816,05/22/2020T00:00:00 ,14,7,2,2,631
12960,05/23/2020T00:00:00 ,303,257,0,0,631
13104,05/24/2020T00:00:00 ,187,150,6,6,637
13248,05/25/2020T00:00:00 ,321,312,2,1,639
13392,05/26/2020T00:00:00 ,45,35,0,0,639
13536,05/27/2020T00:00:00 ,96,68,2,2,641
13680,05/28/2020T00:00:00 ,110,75,1,1,642
13824,05/29/2020T00:00:00 ,33,24,0,0,642
13968,05/30/2020T00:00:00 ,457,348,0,0,642
14112,05/31/2020T00:00:00 ,500,391,14,8,656
14256,06/01/2020T00:00:00 ,497,380,0,0,656
14400,06/02/2020T00:00:00 ,530,398,0,0,656
14544,06/03/2020T00:00:00 ,526,408,0,0,656
14688,06/04/2020T00:00:00 ,518,395,1,1,657
14832,06/05/2020T00:00:00 ,634,473,0,0,657
14976,06/06/2020T00:00:00 ,676,482,11,6,668
15120,06/07/2020T00:00:00 ,770,587,0,0,668
15264,06/08/2020T00:00:00 ,858,666,0,0,668
15408,06/09/2020T00:00:00 ,983,768,0,0,668
15552,06/10/2020T00:00:00 ,1040,740,10,7,678
15696,06/11/2020T00:00:00 ,860,672,0,0,678
15840,06/12/2020T00:00:00 ,853,663,2,2,680
15984,06/13/2020T00:00:00 ,1240,958,0,0,680
16128,06/14/2020T00:00:00 ,1318,1017,2,2,682
16272,06/15/2020T00:00:00 ,1411,1080,0,0,682
16416,06/16/2020T00:00:00 ,1445,1073,8,7,690
16560,06/17/2020T00:00:00 ,1533,1168,0,0,690
16704,06/18/2020T00:00:00 ,1527,1162,0,0,690
16848,06/19/2020T00:00:00 ,1570,1222,0,0,690
16992,06/20/2020T00:00:00 ,1357,985,4,4,694
17136,06/21/2020T00:00:00 ,1315,1030,0,0,694
17280,06/22/2020T00:00:00 ,1284,1000,2,2,696
17424,06/23/2020T00:00:00 ,1237,962,0,0,696
17568,06/24/2020T00:00:00 ,1229,924,1,1,697
17712,06/25/2020T00:00:00 ,1244,962,0,0,697
17856,06/26/2020T00:00:00 ,1319,962,6,5,703
18000,06/27/2020T00:00:00 ,1626,1218,0,0,703
18144,06/28/2020T00:00:00 ,1801,1394,0,0,703
18288,06/29/2020T00:00:00 ,2006,1564,0,0,703
18432,06/30/2020T00:00:00 ,2182,1663,3,3,706
